а	a  
б	b
в	v
г	g  
д	d
е	ye
ё	yo
ж	j
з	z
и	i
й	iy
к	k
л	l
м	m
н	n
о	o
п	p
р	r
с	s
т	t
у	u
ф	f
х	kh
ц	ts
ч	tch
ш	sh
щ	shtch
ы	y
э	e
ю	yu
я	ya
ъ	"
ь	'